Больше машин на дорогах — YLTEICZ
Все машины имеют Нитро-ускоритель — SPEEDFREAK
Дороги забиты «мусорными авто» — EVERYONEISPOOR
Квадроцикл — FOURWHEELFUN
Пляжная вечеринка — LIFESABEACH
Перекрасить машины в черный — IOWDLAC
Взорвать все машины — CPKTNWT
Открыть охоту на главного героя — BAGOWPG
Летающие машины — CHITTYCHITTYBANGBANG
Режим хаоса — STATEOFEMERGENCY
Облачная погода — ALNSFMZO
Ездить по воде — YSOHNUL
Ускорить машины — SPEEDITUP
Ускорить время — YSOHNUL
Ускорить геймплей — FLYINGFISH
Стать толстым — BTCDBCB
Летающие лодки — FLYINGFISH
Туманная погода — CRAZYTOWN
Полное здоровье, полная броня, $250 тыс. — HESOYAM
«Веселый режим» — CRAZYTOWN
Банды контролируют улицы — ONLYHOMIESALLOWED
Получить парашют — AIYPWZQP
Оружие наемного убийцы — PROFESSIONALKILLER
Реактивный самолет — JUMPJET
Бесконечные патроны — FULLCLIP
Бесконечный запас кислорода — CVWKXAM
Научить высоко прыгать — KANGAROO
Усиленные прыжки на транспорте — CJPHONEHOME
Максимум мышечной силы — BUFFMEUP
Максимум уважения — WORSHIPME
Максимум сексуальной привлекательности — HELLOLADIES
Максимум характеристик машин — NATURALTALENT
Перевести день в ночь — NIGHTPROWLER
Оранжевое небо и время останавливается на 21:00 — OFVIAC
Агрессивные пешеходы — IOJUFZN
Пешеходы стреляют в героя — BGLUAWML
Идеальная управляемость транспорта — STICKLIKEGLUE
Все машины розовые — LLQPFBN
Дождливая погода — AUIFRVQS
Набор пешеходов в банду — SJMAHPE
Свободные дороги — GHOSTTOWN
Песчаная буря — CWJXUOC
Похудеть — KVGYZQK
Замедлить геймплей — ANOSEONGLASS
Призвать машину Bloodring Banger — OLDSPEEDDEMON
Призвать машину Caddy — RZHSUEW
Бульдозер — ITSALLBULL
Призвать машину Hotring Racer 1 — VROCKPOKEY
Призвать машину Hotring Racer 2 — VPJTQWV
Призвать машину Hunter — OHDUDE
Получить Jetpack — ROCKETMAN
Призвать машину Monster Truck — MONSTERMASH
Призвать машину Rancher — JQNTDMH
Танк — AIWPRTON
Призвать машину Romero — WHERESTHEFUNERAL
Призвать машину Stretch — CELEBRITYSTATUS
Самолет — FLYINGTOSTUNT
Танкер — AMOMHRER
Мусоровоз — TRUEGRIME
Суицид — GOODBYECRUELWORLD
Солнечная погода — PLEASANTLYWARM
Такси имеют нитро и прыжки — VKYPQCF
Все машины деревенские — FVTMNBZ
Все машины очень быстрые — EVERYONEISRICH
Взорвать транспорт — JCNRUAD
Катер на воздушной подушке — KGGGDKP
Понизить уровень розыска — TURNDOWNTHEHEAT
Поднять уровень розыска — TURNUPTHEHEAT
Прицел сам наводится во время езды — OUIQDMW
Набор оружия 1 — LXGIWYL
Набор оружия 2 — PROFESSIONALSKIT
Набор оружия 3 — UZUMYMW