More cars on the roads — YLTEICZ
All cars have a Nitro accelerator — SPEEDFREAK
Roads are clogged with "garbage cars" — EVERYONEISPOOR
ATV — FOURWHEELFUN
Beach Party — LIFESABEACH
Repaint cars in black — IOWDLAC
Blow up all the cars — CPKTNWT
Open the hunt for the main character — BAGOWPG
Flying cars — CHITTYCHITTYBANGBANG
Chaos Mode — STATEOFEMERGENCY
Cloudy weather — ALNSFMZO
Ride on water — YSOHNUL
Speed up cars — SPEEDITUP
Speed up time — YSOHNUL
Speed up gameplay — FLYINGFISH
Getting Fat — BTCDBCB
Flying Boats — FLYINGFISH
Foggy weather — CRAZYTOWN
Full Health, Full Armor, $250k — HESOYAM
"Fun Mode" — CRAZYTOWN
Gangs control the streets — ONLYHOMIESALLOWED
Get a parachute — AIYPWZQP
Assassin's Weapon — PROFESSIONALKILLER
Jet plane — JUMPJET
Endless Rounds — FULLCLIP
Endless supply of oxygen — CVWKXAM
Teach how to jump high — KANGAROO
Enhanced jumps on transport — CJPHONEHOME
Maximum muscle strength — BUFFMEUP
Maximum respect — WORSHIPME
Maximum sexual attractiveness — HELLOLADIES
Maximum performance of machines — NATURALTALENT
Turn day into night — NIGHTPROWLER
Orange sky and time stops at 21:00 — OFVIAC
Aggressive pedestrians — IOJUFZN
Pedestrians shoot at the hero — BGLUAWML
Perfect transport handling — STICKLIKEGLUE
All cars are pink — LLQPFBN
Rainy weather — AUIFRVQS
A set of pedestrians in a gang — SJMAHPE
Free Roads — GHOSTTOWN
Sandstorm — CWJXUOC
Lose weight — KVGYZQK
Slow down gameplay — ANOSEONGLASS
Summon the Bloodring Banger Machine — OLDSPEEDDEMON
Summon a Caddy Car — RZHSUEW
Bulldozer — ITSALLBULL
Summon the Hotring Racer 1 Car — VROCKPOKEY
Summon the Hotring Racer 2 Car — VPJTQWV
Summon the Hunter — OHDUDE machine
Get Jetpack — ROCKETMAN
Summon a Monster Truck — MONSTERMASH
Summon a Rancher Machine — JQNTDMH
Tank — AIWPRTON
Summon the Romero Machine — WHERESTHEFUNERAL
Summon the Stretch Machine — CELEBRITYSTATUS
Airplane — FLYINGTOSTUNT
Tanker — AMOMHRER
Garbage truck — TRUEGRIME
Suicide — GOODBYECRUELWORLD
Sunny weather — PLEASANTLYWARM
Taxis have nitro and jumps — VKYPQCF
All cars are rustic — FVTMNBZ
All cars are very fast — EVERYONEISRICH
Blow up a transport — JCNRUAD
Hovercraft — KGGGDKP
Lower the search level — TURNDOWNTHEHEAT
Raise the search level — TURNUPTHEHEAT
The sight is self—guided while driving - OUIQDMW
Weapon Set 1 — LXGIWYL
Weapon Set 2 — PROFESSIONALSKIT
Weapon Set 3 — UZUMYMW